...###
..##.#.##..
.##..#.#..#
##........#
#...@..#..#
###..###..#
..#..#....#
.##.##.#.##
.#..##..##
.#.....##
.#####.#