...###
..##.#.###.
.##..###..#
##........#
#..#@#.#..#
##..####..#
..#..#....#
.##.##.#.##
.#......##
.#.....##
.#####..