...###.....
..##.#.##.#
.##..###..#
##..##....#
#...@#.#..#
.##.#.##..#
..#..#....#
.##.##.#.##
.#......##.
.#.....##..
.##..###...